00000000000000000000000000000000000000000000000000000000000000000000000000000000000000000
00000000000000000000000000000000000000000000000000055555555555500000000000000000000000000
00000000000000000000000000000000000000000000000000555555555555550000000000000000000000000
00000000000000000000000000000000000000000000000000555555555555550000000000000000000000000
00000000000000000000000000000000000000000000000000555555GG5555550000000000000000000000000
00000000000000000000000000000000000000000000000000555555555555550000000000000000000000000
00000000000000000000000000000000000000000000000000005550000555000000000000000000000000000
00000000000000000000000000000000000000000000000000005550000555000000000000000000000000000
00000000000000000000000000000000000000000000000000000555555550000000000000000000000000000
00000000000000000000000000000000000000000000000000000005555000000000000000000000000000000
00000000000000000000000000000000000000000000000000000005555000000000000000000000000000000
00000000000000000000000000000000000000000000000000000005555000000000000000000000000000000
00000000000000000000000000000000000000000000000555555555555555555550000000000000000000000
00000000000000000000000000000000000000000000000000000005555000000000000000000000000000000
00000000000000000000000000000000000000000000000000000005555000000000000000000000000000000
00000000000000000000000000000000000000000000000000000055555500000000000000000000000000000
00000000000000000000000000000000000000000000000000000055555500000000000000000000000000000
00000000000000000000000000000000000000000000000000000055555500000000000000000000000000000
00000000000000000000000000000000000000000000000000000055555500000000000000000000000000000
00000000000000000000000000000000000000000000000000000005555000000000000000000000000000000
00000000000000000000000000000000000000000000000000000005555000000000000000000000000000000
00000000000000000000000000000000000000000000000000000055555500000000000000000000000000000
00000000000000000000000000000000000000000000000000000055555500000000000000000000000000000
00000000000000000000000000000000000000000000000000000055555500000000000000000000000000000
00000000000000000000000000000000000000000000000000000005555000000000000000000000000000000
00000000000000000000000000000000000000000000000000000005555000000000000000000000000000000
00000000000000000000000000000000000000000000000000000055555500000000000000000000000000000
00000000000000000000000000000000000000000000000000000055555500000000000000000000000000000
00000000000000000000000000000000000000000000000000000055555500000000000000000000000000000
00000000000000000000000000000000000000000000000000000055555500000000000000000000000000000
00000000000000000000000000000000000000000000000000000055555500000000000000000000000000000
00000000000000000000000000000000000000000000000000000055555500000000000000000000000000000
00000000000000000000000000000000000000000000000000000055555500000000000000000000000000000
00000000000000000000000000000000000000000000000000000055555500000000000000000000000000000
00000000000000000000000000000000000000000000000000000055555500000000000000000000000000000
00000000000000000000000000000000000000000000000000000055555500000000000000000000000000000
00000000000000000000000000000000000000000000000000000055555500000000000000000000000000000
00000000000000000000000000000000000000000000000000000055555500000000000000000000000000000
00000000000000000000000000000000000000000000000000000055555500000000000000000000000000000
00000000000000000000000000000000000000000000000000000055555500000000000000000000000000000
00000000000000000000000000000000000000000000000000000055555500000000000000000000000000000
00000000000000000000000000000000000000000000000000000055555500000000000000000000000000000
00000000000000000000000000000000000000000000000000000055555500000000000000000000000000000
00000000000000000000000000000000000000000000000000000055555500000000000000000000000000000
00000000000000000000000000000000000000000000000000000055555500000000000000000000000000000
00000000000000000000000000000000000000000000000000000055555500000000000000000000000000000
00000000000000000000000000000000000000000000000000000055555500000000000000000000000000000
00000000000000000000000000000000000000000000000000000000550000000000000000000000000000000
00000000000000000000000000000000000000000000000000000000110000000000000000000000000000000
00000000000000000000000000000000000000000000000000000000000000000000000000000000000000000
00000000000000000000000000000000000000000000000000000000000000000000000000000000000000000